111111111111111111111
1PCE00000000000000001
101000000000000000001
111111111111111111111
