111111
11C111
101P01
1E1001
111111
