11111111111111111111111111111111
10000000000000000000000000000001
1000C0C0000000010000100001000011
10000000000000000000000000000001
10000000000000000000000000000001
11111111111111100111111111111111
1000P00000000000000000000000E011
11111111111111111111111111111111