111111111111111111111
1P0000001000000000001
101011101011111110101
101X00101010C00000101
101110101010100010101
1010C0101010100X10001
101010101000101110C01
101010X00010100000X01
101010100010111110C01
111010100000X000C0101
10C000111111100X00101
101000101000C00111101
101110101011111110X01
10C010001010X00C00101
111010111010111111101
1000X0000010100X00101
111111101110101110C01
1X0000000X00001X00C01
11111C111111111011101
100000000000000E00001
111111111111111111111
