11111111111111111111111111111111
1T00000T000000000000T00000000001
100XC0C000000001000T100001000011
10000000000000000000000000000001
1000000000000000T000000000000001
1111111111111110T111111111111111
1000P00000000000000000000000E011
11111111111111111111111111111111
