1111111111111111111111111
1P00000000000000000000001
1111011111110111110111111
1C00000000000000000000001
1111011111011111011111011
1C0000000000C0000000000C1
1111110111111111011111111
1000000000000000000000001
1011111111011111111011111
1C0000000C0000000C0000001
1111111011111011111011111
10000000000000000000000E1
1111111111111111111111111