1111111111111111111111111
1P00000000000000000000001
1111011111110111110111111
1000010000010000010000011
1011111111011111011111011
1C000000000C00000000000C1
1111011111011111011111011
1000010000010000010000011
1011111011111111111111011
1C000000000C00000000000C1
1111111011111011111011111
1E00000000000000000000001
1111111111111111111111111