1111111111111111111111111111111111111111111
100C00000P000000000000000000000000000C00001
1000011100C00001110000000111000000011100001
1000000100000000010000000001000000010100001
1000000100000001110000000111000000000100001
1000000100000000010000000001000000000100001
1000000100C00001110000000111000000000100001
1000C000000000000000000000000000000000C00E1
1111111111111111111111111111111111111111111
