111111111111111111111
1P0000000000C00000001
101000000000000000001
1000EC000000000000001
100000000000C00000001
100000000000000000001
100000000000000000001
100000001000000000001
100000000000000000001
100000000C00000000001
1000C0000000C00000001
111111111111111111111








