111111
101C11
100P01
1E1001
111111

