1111111111111111111111111111111
1P00000000000000000000000000001
1011111011111011111011111011111
1C000000000000000000000000000C1
1011111111011111011111011111011
1C000000000C00000000000000000C1
1111110111111111011111111111111
1000000000000000000000000000001
1111111111011111111011111111011
1C0000000C0000000C00000000000C1
1011111011111011111011111011111
1E00000000000000000000000000001
1111111111111111111111111111111

