1111111111111111111111111
1P00000000000000000000001
1011111011111011111011111
1C00000100000000000100001
1111011111011111011111011
1000000000C00000000000001
1011111111111011111111111
1000000000000000000000001
1011111011111111111011111
1C000000000000C00000000C1
1111011111011111011111011
1E00000000000000000000001
1111111111111111111111111

